15
15
01-01-01-01-01-01-01-01-01-01-01-01-01-01-01
01-04-02-03-02-02-01-01-01-02-02-02-02-04-01
01-02-01-02-01-02-02-01-02-02-01-02-01-02-01
01-02-01-02-01-01-02-01-02-01-01-02-01-02-01
01-02-01-02-02-01-02-01-02-01-02-02-01-02-01
01-02-01-01-02-02-02-00-02-03-02-01-01-02-01
01-02-02-02-02-01-01-09-01-01-02-02-02-02-01
01-02-01-01-02-01-07-06-08-01-02-01-01-02-01
01-02-01-02-02-01-01-01-01-01-02-02-01-02-01
01-02-02-02-01-01-01-05-01-01-01-02-02-02-01
01-02-01-02-01-02-02-02-02-02-01-02-01-02-01
01-02-01-02-02-02-01-02-01-02-02-02-01-02-01
01-02-01-01-02-01-01-02-01-01-02-01-01-02-01
01-04-02-02-02-02-02-02-02-02-02-02-02-04-01
01-01-01-01-01-01-01-01-01-01-01-01-01-01-01