28
25
01-01-01-01-01-01-01-01-01-01-01-01-01-01-01-01-01-01-01-01-01-01-01-01-01-01-01-01
01-02-02-02-02-02-02-02-02-02-02-02-02-01-01-02-02-02-02-02-02-02-02-02-02-02-02-01
01-02-01-01-01-01-02-01-01-01-01-01-02-01-01-02-01-01-01-01-01-02-01-01-01-01-02-01
01-03-01-01-01-01-02-01-01-01-01-01-02-01-01-02-01-01-01-01-01-02-01-01-01-01-03-01
01-02-01-01-01-01-02-01-01-01-01-01-02-01-01-02-01-01-01-01-01-02-01-01-01-01-02-01
01-02-02-02-02-02-02-02-02-02-02-02-02-02-02-02-02-02-02-02-02-02-02-02-02-02-02-01
01-02-01-01-01-01-02-01-01-02-01-01-01-01-01-01-01-01-02-01-01-02-01-01-01-01-02-01
01-02-01-01-01-01-02-01-01-02-01-01-01-01-01-01-01-01-02-01-01-02-01-01-01-01-02-01
01-02-02-02-02-02-02-01-01-02-02-02-02-01-01-02-02-02-02-01-01-02-02-02-02-02-02-01
01-01-01-01-01-01-02-01-01-01-01-01-00-01-01-00-01-01-01-01-01-02-01-01-01-01-01-01
00-00-00-00-00-01-02-01-01-00-00-00-00-00-00-00-00-00-00-01-01-02-01-00-00-00-00-00
00-00-00-00-00-01-02-01-01-00-01-01-01-00-00-01-01-01-00-01-01-02-01-00-00-00-00-00
00-00-00-00-00-01-02-02-02-00-01-06-07-00-08-09-00-01-00-00-00-02-01-00-00-00-00-00
00-00-00-00-00-01-02-01-01-00-01-01-01-01-01-01-01-01-00-01-01-02-01-00-00-00-00-00
00-00-00-00-00-01-02-01-01-00-00-00-00-04-00-00-00-00-00-01-01-02-01-00-00-00-00-00
01-01-01-01-01-01-02-01-01-01-01-01-00-01-01-00-01-01-01-01-01-02-01-01-01-01-01-01
01-02-02-02-02-02-02-01-01-02-02-02-02-01-01-02-02-02-02-01-01-02-02-02-02-02-02-01
01-02-01-01-01-01-02-01-01-02-01-01-01-01-01-01-01-01-02-01-01-02-01-01-01-01-02-01
01-02-01-01-01-01-02-01-01-02-01-01-01-01-01-01-01-01-02-01-01-02-01-01-01-01-02-01
01-02-02-02-02-02-02-02-02-02-02-02-02-02-05-02-02-02-02-02-02-02-02-02-02-02-02-01
01-02-01-01-01-01-02-01-01-01-01-01-02-01-01-02-01-01-01-01-01-02-01-01-01-01-02-01
01-03-01-01-01-01-02-01-01-01-01-01-02-01-01-02-01-01-01-01-01-02-01-01-01-01-03-01
01-02-01-01-01-01-02-01-01-01-01-01-02-01-01-02-01-01-01-01-01-02-01-01-01-01-02-01
01-02-02-02-02-02-02-02-02-02-02-02-02-01-01-02-02-02-02-02-02-02-02-02-02-02-02-01
01-01-01-01-01-01-01-01-01-01-01-01-01-01-01-01-01-01-01-01-01-01-01-01-01-01-01-01