30
15
01-01-01-01-01-01-01-01-01-01-01-01-01-01-01-01-01-01-01-01-01-01-01-01-01-01-01-01-01-01
01-08-00-00-00-00-00-00-00-00-01-00-00-00-00-01-00-00-00-00-00-00-00-00-01-00-00-00-09-01
01-00-00-00-00-00-00-00-00-00-00-00-00-00-04-00-00-00-01-00-00-00-00-00-01-00-00-00-00-01
01-00-00-00-00-00-00-01-02-00-00-00-00-00-00-00-00-00-00-00-00-00-00-00-00-00-00-00-00-01
01-00-00-00-00-01-00-00-00-00-00-00-00-00-00-00-00-00-00-00-00-00-00-00-00-00-00-00-00-01
01-00-00-00-00-00-00-00-00-00-00-00-00-00-00-00-00-00-00-00-00-01-01-00-00-00-00-00-00-01
01-00-00-00-00-00-00-00-00-00-00-00-00-00-00-00-00-00-00-00-00-01-00-00-00-00-00-00-00-01
01-00-00-00-00-04-00-00-00-00-00-00-00-00-05-00-00-00-00-00-00-04-00-00-00-00-00-00-00-01
01-00-00-00-00-00-00-00-00-00-00-00-00-00-00-00-00-00-00-01-00-00-00-00-00-00-00-00-00-01
01-00-00-00-00-00-00-00-00-00-00-00-00-00-00-00-00-00-00-00-00-00-00-00-00-00-00-00-00-01
01-00-00-00-00-01-00-00-00-00-00-00-00-00-00-00-00-00-00-00-00-00-00-00-00-00-00-00-00-01
01-00-01-00-00-00-00-00-00-00-00-00-00-00-00-00-00-00-00-00-00-00-00-00-00-00-00-00-00-01
01-00-01-00-00-00-00-00-00-00-01-00-00-00-04-00-00-00-00-00-00-00-01-00-00-00-00-00-00-01
01-06-01-00-00-00-00-00-00-00-00-00-00-00-00-00-00-00-00-00-00-00-00-00-00-00-00-00-07-01
01-01-01-01-01-01-01-01-01-01-01-01-01-01-01-01-01-01-01-01-01-01-01-01-01-01-01-01-01-01