30
15
01-01-01-01-01-01-01-01-01-01-01-01-01-01-01-01-01-01-01-01-01-01-01-01-01-01-01-01-01-01
01-08-02-02-02-02-02-02-02-02-01-02-02-02-03-01-02-02-02-02-02-02-02-02-01-02-02-02-09-01
01-02-02-02-02-02-02-02-02-02-02-02-02-02-04-02-02-02-01-02-02-02-02-02-01-02-02-02-02-01
01-02-02-02-02-02-02-01-02-02-02-02-02-02-02-02-02-02-02-02-02-02-02-02-02-02-02-02-02-01
01-02-02-02-02-01-02-02-02-02-02-02-02-02-02-02-02-02-02-02-02-02-02-02-02-02-02-02-02-01
01-02-02-02-02-02-02-02-02-02-02-02-02-02-02-02-02-02-02-02-02-01-01-02-02-02-02-02-02-01
01-02-02-02-02-02-02-02-02-02-02-02-02-02-02-02-02-02-02-02-02-01-02-02-02-02-02-02-02-01
01-03-02-02-02-04-02-02-02-02-02-02-02-02-05-02-02-02-02-02-02-04-02-02-02-02-02-02-03-01
01-02-02-02-02-02-02-02-02-02-02-02-02-02-02-02-02-02-02-01-02-02-02-02-02-02-02-02-02-01
01-02-02-02-02-02-02-02-02-02-02-02-02-02-02-02-02-02-02-02-02-02-02-02-02-02-02-02-02-01
01-02-02-02-02-01-02-02-02-02-02-02-02-02-02-02-02-02-02-02-02-02-02-02-02-02-02-02-02-01
01-02-01-02-02-02-02-02-02-02-02-02-02-02-02-02-02-02-02-02-02-02-02-02-02-02-02-02-02-01
01-02-01-02-02-02-02-02-02-02-01-02-02-02-04-02-02-02-02-02-02-02-01-02-02-02-02-02-02-01
01-06-01-02-02-02-02-02-02-02-02-02-02-02-03-02-02-02-02-02-02-02-02-02-02-02-02-02-07-01
01-01-01-01-01-01-01-01-01-01-01-01-01-01-01-01-01-01-01-01-01-01-01-01-01-01-01-01-01-01