19
24
01-01-01-01-01-01-01-01-01-01-01-01-01-01-01-01-01-01-01
01-04-08-02-04-04-04-04-04-04-04-04-04-04-04-04-04-04-01
01-04-04-04-04-04-04-04-04-04-04-04-04-04-04-04-04-04-01
01-04-04-04-04-04-04-04-04-04-04-04-04-04-04-04-04-04-01
01-04-04-05-04-04-04-04-04-04-04-04-04-04-04-04-04-04-01
01-04-04-04-04-04-04-04-04-04-04-04-04-04-04-04-04-04-01
01-04-04-04-04-04-04-04-04-04-04-04-06-04-04-04-04-04-01
01-04-04-04-04-04-04-04-04-04-04-04-04-04-04-04-04-04-01
01-04-04-04-04-04-04-04-04-04-04-04-04-04-04-04-04-04-01
01-04-04-04-04-04-04-04-04-04-04-04-04-04-04-04-04-04-01
01-04-04-04-04-04-04-04-04-04-04-04-04-04-04-04-04-04-01
01-04-04-04-04-04-04-04-04-04-04-04-04-04-04-04-04-04-01
01-04-04-04-04-04-04-04-04-04-04-04-04-04-04-04-04-04-01
01-04-04-04-04-04-04-04-04-04-04-04-04-04-04-04-04-04-01
01-04-04-04-04-04-04-04-04-04-04-04-04-04-04-04-04-04-01
01-04-04-04-04-04-04-04-04-04-04-04-04-04-04-04-04-04-01
01-04-04-04-04-04-04-04-04-04-04-04-04-09-04-04-04-04-01
01-04-04-04-04-04-04-04-04-04-04-04-04-04-04-04-04-04-01
01-04-04-04-04-04-04-04-04-04-04-04-04-04-04-04-04-04-01
01-04-04-04-04-04-04-04-04-04-04-04-04-04-04-04-04-04-01
01-04-04-04-04-04-07-04-04-04-04-04-04-04-04-04-04-04-01
01-04-04-04-04-04-04-04-04-04-04-04-04-04-04-04-04-04-01
01-04-04-04-04-04-04-04-04-04-04-04-04-04-04-04-04-04-01
01-01-01-01-01-01-01-01-01-01-01-01-01-01-01-01-01-01-01